+++++++++++++++++++++++
++S            +      +
++++++++++++   +      +
+              + +    +
+  ++  ++++    + +    +
+  ++     +    +      +
+  ++     +    +      E
+  ++  +++++++++      +
+  ++     ++   +      +
+  +                  +
+++++++++++++++++++++++
