++++++++++
+S       +
+    +   +
+    +   +
+       +
++++++++++