++++++++++++++++++++++
++S            +     +
++++++++++++   +     +
+              + +   +
+  ++  ++++    + +   +
+  ++     +    +     +
+  ++     +    +      
+  ++  +++++++++     +
+  ++     ++   +     +
+  +                 +
+++++++++++++++++++++++