+   S+       +     +
+   +++  ++++++++  +
+ +      +      +  +
+ + + ++ + ++++ +  +
+ + +  + +    + +  +
+ + +  ++++++ + +  +
+   +         + +  +
+ +++++++++++++ +  +
+          +       +
+++++++++++++++++E++