++++++++++++++++++++
+S  +              +
+ + + +++   +++ +  +
+ +     +       +  +
+ ++++  + + +++++  +
+ +  +  + +     +  +
+ ++ +  + + +++ +  E
+    +  +   + + +  +
++++ +++++++ + +++ +
